a = AIR
b = BRICK
c = SPECIAL
d = FLOOR
e = BLOCK
f = INVISIBLE SPECIAL
g = PIPE BODY LEFT
h = PIPE BODY RIGHT
i = PIPE TOP LEFT
j = PIPE TOP RIGHT
k = PIPE BODY TOP
l = PIPE BODY BOTTOM
m = PIPE BOTTOM LEFT
n = PIPE BOTTOM RIGHT
o = PIPE LEFT TOP
p = PIPE LEFT BOTTOM
q = PIPE RIGHT TOP
r = PIPE RIGHT BOTTOM
s = PIPE INNER TOP LEFT
t = PIPE INNER TOP RIGHT
u = PIPE INNER BOTTOM LEFT
v = PIPE INNER BOTTOM RIGHT
w = PIPE CORNER TOP LEFT
x = PIPE CORNER TOP RIGHT
y = PIPE CORNER BOTTOM LEFT
z = PIPE CORNER BOTTOM RIGHT
A = FLAGPOLE
B = FLAGPOLE TIP
C = CASTLE DOOR BOTTOM
D = CASTLE DOOR ARCH
E = CASTLE CRENNELATIONS SKY
F = CASTLE CRENNELATIONS BRICK
G = CASTLE WINDOW RIGHT (of brick)
H = CASTLE WINDOW LEFT (of brick)
I = CASTLE BRICKS
J = CLOUD TOP LEFT
K = CLOUD TOP MIDDLE
L = CLOUD TOP RIGHT
M = CLOUD BOTTOM LEFT
N = CLOUD BOTTOM MIDDLE
O = CLOUD BOTTOM RIGHT
P = BUSH TOP LEFT
Q = BUSH TOP MIDDLE
R = BUSH TOP RIGHT
S = HILL TOP
T = HILL DOT
U = HILL LEFT
V = HILL RIGHT
W = HILL BLANK
X = COIN
Y = GOOMBA
Z = POWERUP
0 = 1UP
1 = BRICK COIN
2 = BRICK STAR
3 = KOOPAS
